

Unsolved maze:
%%%%%%%%%%%
S %       %
  % %%%%% %
% % %   %  
% % % % %%%
% %   %   %
  %%%%%%% %
% % %     %
% % % % %%%
      %   E
% %%%%%% %%

Solved maze:
%%%%%%%%%%%
S %       %
**% %%%%% %
%*% %   %  
%*% % % %%%
%*%   %   %
 *%%%%%%% %
%*% %***  %
%*% %*%*%%%
 *****%***E
% %%%%%% %%

Solution to maze is valid

